F 220, 10,0
NO ./textures/Wadha.xpm
SO ./textures/Black_Hole.xpm
C 255    ,    255    ,    100
WE ./textures/Mohamed.xpm
EA ./textures/Sky.xpm



        1111111111111111111111111
        1000000000110000000000001
        1011000001110000000000001
        1001000000000000000000001
111111111011000001110000000000001
100000000011000001110111111111111
111111111111111111011111111111111
11111111111111111111111111111
1100000011 101011100000010001
100000000 0 0000001100000010001
1000000000 000001101010010001
11000001110101011111011110001
11110111 1110101 101111010001
11111111 1111111 111111111111

     