
F 250,110,0

C 20,50,100

NO ./textures/factoryironstone1.xpm
SO ./textures/factoryironstone1.xpm
WE ./textures/bookshelf_02.xpm
EA ./textures/bookshelf_02.xpm




111111
100001
10W001
111111
