NO ./textures/Wadha.xpm
SO ./textures/Black_Hole.xpm
WE ./textures/Mohamed.xpm
EA ./textures/Mohamed.xpm
F 220, 10,0 

C 25 5, 255, 10 0


        1111111111111111111111111
        1000000000110000000000001
        1011000001110000000000001
        1001000000000000000000001
111111111011000001110000000000001
100000000011000001110111111111111
111111111111111111011111111111111
11111111111111111111111111111
1100000011101011100000010001
10000000000000001100000010001
1000000000N000001101010010001
11000001110101011111011110001
11110111 1110101 101111010001
11111111 1111111 111111111111

     