
F 250,10,0


NO ./textures/Wadha.xpm
SO ./textures/Black_Hole.xpm
C 255,255,100
WE ./textures/Mohamed.xpm
EA ./textures/Mohamed.xpm

1111111111
1000000001
1000000001
1000000001
1000000001
1001000001
101N000001
1001000001
1000000001
1000000001
1000000001
1000000001
1000000001
1000000001
1000000001
1000000001
1000000001
1111111111